List of the plugins in web site.

  1. Activity Log => Get aware of any activities that are taking place on your dashboard
  2. Advanced Custom Fields PRO => Customize WordPress with powerful, professional and intuitive fields
  3. Advanced noCaptcha & invisible Captcha => Show noCaptcha or invisible captcha
  4. Akismet Anti-Spam => Used by millions, Akismet is quite possibly the best way in the world to protect your blog from spam
  5. bbPress => bbPress is forum software with a twist from the creators of WordPress
  6. Contact Form 7
  7. Convert Plus => the easiest WordPress plugin to convert website traffic into leads
  8. Custom Fonts => Custom Fonts allows you to add more fonts that extend formatting options in your site
  9. Easy Login Styler => Simple Login Page Customization
  10. Fusion Builder => ThemeFusion Page Builder Plugin
  11. Fusion Core => White Label Branding plugin for ThemeFusion Products
  12.Fusion White Label Branding
  13. Gravity Forms
  14. HC Custom WP-Admin URL => Small and simple plugin that allows you to change the url of wp-admin
  15. Invisible reCaptcha => Google Invisible reCaptcha for WordPres
  16. LayerSlider WP => LayerSlider is a premium multi-purpose content creation and animation platform
  17. LiteSpeed Cache => High-performance page caching and site optimization from LiteSpeed
  18. Login No Captcha reCAPTCHA (Google) => Adds a Google CAPTCHA checkbox to the login, registration, and forgot password forms, thwarting automated hacking attempts
  19. Login Page Styler => This plugin allows you to customize the appearance of the WordPress Login Screen as you like to see
  20. Polylang => Adds multilingual capability to WordPress
  21. Slider Revolution => Slider Revolution - Premium responsive slider
  22. Smush Pro => Reduce image file sizes, improve performance and boost your SEO using the free WPMU DEV WordPress Smush API.
  23. The Events Calendar => The Events Calendar is a carefully crafted, extensible plugin that lets you easily share your events. Beautiful. Solid. Awesome
  24. User Role Editor => Change/add/delete WordPress user roles and capabilities
  25. WordPress Importer => Import posts, pages, comments, custom fields, categories, tags and more from a WordPress export file
  26. WP Statistics
  27. wp-jalali
  28. WP-Parsidate => Persian package for WordPress, Adds full RTL and Shamsi (Jalali) support for: posts, comments, pages, archives, search, categories, permalinks and all admin sections and TinyMce editor, lists, quick editor. This package has Jalali archive widget
  29. WPMU DEV Dashboard
